2x50x50;

04,06,07,08,09,12,17,18,21,22,23,24,25,26,27,29,30,31,34,36,37,38,42,44,47,49,57,58,59,62,67,68,70,75,78,81,84,85,86,87,89,90;

--,--,--,--,--,--,--,--,--,--,--,--,--,--,--,--,--,--,--,--,--,--,--,--,--,--,--,--,--,--,--,--,--,--,--,--,--,--,--,--,--,--,--,--,--,--,--,--,--,--,
--,--,--,--,--,--,--,--,--,--,--,--,--,--,--,--,--,--,--,--,--,--,--,--,--,--,--,--,--,--,--,--,--,--,--,--,--,--,--,--,--,--,--,--,--,--,--,--,--,--,
--,--,--,--,--,--,--,--,--,--,--,--,--,--,--,--,--,--,--,--,--,--,--,--,--,--,--,--,--,--,--,--,--,--,--,--,--,--,--,--,--,--,--,--,--,--,--,--,--,--,
--,--,--,--,--,--,--,--,--,--,--,--,--,--,--,--,--,--,--,--,--,--,--,--,--,--,--,--,--,--,--,--,--,--,--,--,--,--,--,--,--,--,--,--,--,--,--,--,--,--,
--,--,--,--,--,--,--,--,--,--,--,--,--,--,--,--,--,--,--,--,--,--,--,--,--,--,--,--,--,--,--,--,--,--,--,--,--,--,--,--,--,--,--,--,--,--,--,--,--,--,
--,--,--,--,--,--,--,--,--,--,--,--,--,--,--,--,--,--,--,--,--,--,--,--,--,--,--,--,--,--,--,--,--,--,--,--,--,--,--,--,--,--,--,--,--,--,--,--,--,--,
--,--,--,--,--,--,--,--,--,--,--,--,--,--,--,--,--,--,--,--,--,--,--,--,--,--,--,--,--,--,--,--,--,--,--,--,--,--,--,--,--,--,--,--,--,--,--,--,--,--,
--,--,--,--,--,--,--,--,--,--,--,--,--,--,--,--,--,--,--,--,--,--,--,--,--,--,--,--,--,--,--,--,--,--,--,00,02,03,01,02,03,04,--,--,--,--,--,--,--,--,
--,--,--,--,00,03,02,01,04,--,--,--,--,--,--,--,--,--,--,--,--,--,--,--,--,--,--,--,--,--,--,--,--,--,--,63,43,12,13,13,14,46,--,--,--,--,--,--,--,--,
--,--,--,--,42,12,14,23,46,--,--,--,--,--,--,--,--,--,--,--,--,--,--,--,--,--,--,--,--,--,--,--,--,--,--,42,64,33,34,34,35,51,04,--,--,--,--,--,--,--,
--,--,--,--,21,54,56,66,25,--,--,--,--,--,--,--,--,--,91,--,--,--,--,--,--,00,02,01,02,03,04,--,--,--,--,21,66,33,34,34,36,14,25,--,--,--,--,--,--,--,
--,--,--,--,63,23,45,22,67,--,--,--,--,--,--,--,--,91,78,69,70,--,--,--,--,21,43,45,44,23,46,--,--,--,--,63,65,33,34,34,34,35,46,--,--,--,--,--,--,--,
--,--,--,--,42,44,24,43,51,01,01,04,--,--,--,69,70,78,78,78,78,91,--,--,--,84,87,31,64,45,66,48,48,48,48,66,23,54,16,34,34,35,67,--,--,--,--,--,--,--,
--,--,--,--,21,65,22,45,66,23,44,46,--,--,--,78,78,73,78,78,78,78,--,--,--,90,90,84,86,87,88,90,90,90,90,42,45,64,33,34,34,35,46,--,--,--,--,--,--,--,
--,--,--,--,84,86,85,87,86,24,22,88,--,--,--,00,02,03,01,02,01,04,--,--,--,--,--,90,90,28,90,--,--,--,--,63,43,22,54,55,55,56,67,--,--,--,--,--,--,--,
--,--,--,--,77,78,78,78,78,09,10,77,--,--,--,42,45,65,43,12,14,46,--,--,--,--,--,--,--,28,--,--,--,--,--,84,87,85,87,86,85,87,88,--,--,--,--,--,--,--,
--,--,--,--,90,90,90,90,63,23,45,25,--,--,--,84,86,31,22,54,56,51,02,03,01,02,04,--,--,28,--,--,--,--,--,78,78,78,09,10,78,78,78,--,--,--,--,--,--,--,
--,--,--,--,--,--,--,--,42,44,43,46,--,--,--,90,90,63,44,43,22,30,86,85,87,86,51,48,48,86,48,07,--,--,--,90,90,78,09,10,78,78,78,--,--,--,--,--,--,--,
--,--,--,--,--,--,--,--,21,22,65,43,48,48,48,48,48,43,45,22,65,46,90,90,90,90,11,90,90,90,90,47,48,48,48,07,--,78,09,10,78,73,78,--,--,--,--,--,--,--,
--,--,--,--,--,--,--,--,63,64,24,67,90,90,90,90,90,42,43,43,44,67,--,--,--,--,32,--,--,--,--,90,90,90,90,28,--,00,22,23,03,02,03,02,04,--,--,--,--,--,
--,--,--,--,--,--,--,--,84,23,87,88,--,--,--,--,--,84,86,85,87,88,--,--,05,48,49,--,--,--,--,--,--,--,--,28,--,42,45,43,23,24,12,14,46,--,--,--,--,--,
--,--,--,--,--,--,--,--,90,28,90,90,--,--,--,--,--,77,78,11,78,78,--,--,26,90,90,--,--,--,00,04,--,--,--,28,--,63,23,44,24,45,54,56,25,--,--,--,--,--,
--,--,--,--,--,--,--,--,--,28,--,--,--,--,00,03,02,77,78,32,78,78,--,--,26,--,--,--,--,--,42,64,48,48,48,86,48,21,24,65,22,44,30,87,88,--,--,--,--,--,
--,--,--,--,--,--,--,--,--,11,--,--,--,--,42,22,65,77,94,11,78,78,04,--,42,48,48,07,--,--,21,67,90,90,90,90,90,42,43,44,23,65,46,90,90,--,--,--,--,--,
--,--,--,--,--,--,--,--,--,32,--,--,--,--,21,23,44,43,59,22,43,65,46,--,32,90,90,28,--,--,42,25,--,--,--,--,--,84,45,85,87,86,88,--,--,--,--,--,--,--,
--,--,--,--,--,--,--,--,--,47,02,04,--,--,63,44,24,64,59,44,66,45,43,48,49,--,--,26,--,--,63,46,--,--,--,--,--,90,26,90,90,90,90,--,--,--,--,--,--,--,
--,--,--,--,--,--,--,--,--,90,09,10,--,--,21,66,43,66,59,23,22,65,67,90,90,--,--,26,--,--,42,51,03,02,03,04,--,--,26,--,--,--,--,--,--,--,--,--,--,--,
--,--,--,--,--,--,--,--,--,--,63,43,48,48,45,23,65,45,59,44,44,43,46,--,--,--,--,47,48,48,43,45,64,22,65,46,--,--,26,--,--,--,--,--,--,--,--,--,--,--,
--,--,--,--,--,--,--,--,--,05,86,88,--,--,42,74,80,80,81,66,23,30,88,--,--,--,--,90,90,90,63,44,45,44,24,25,--,--,26,--,--,--,--,--,--,--,--,--,--,--,
--,--,--,--,--,--,--,--,--,26,90,90,--,--,21,59,45,43,24,64,44,46,90,--,--,--,--,--,--,--,63,24,64,65,22,64,48,48,49,--,--,--,--,--,--,--,--,--,--,--,
--,--,--,--,--,--,--,--,--,26,--,--,--,--,42,59,22,64,65,43,23,23,06,06,06,06,07,--,--,--,84,86,85,87,86,88,90,90,90,--,--,--,--,--,--,--,--,--,--,--,
--,--,--,--,--,--,--,--,--,26,--,--,--,--,63,59,30,86,86,87,86,88,90,90,90,90,28,--,--,--,77,78,11,78,78,78,--,--,--,--,--,--,--,--,--,--,--,--,--,--,
--,--,--,--,--,00,02,03,01,43,03,02,04,--,84,59,88,90,90,26,90,90,--,--,--,--,28,--,--,--,77,78,32,78,78,78,--,--,--,--,--,--,--,--,--,--,--,--,--,--,
--,--,--,--,--,42,24,44,64,23,44,22,25,--,90,57,90,--,--,26,--,--,--,--,--,--,28,--,--,--,77,78,11,78,78,78,--,--,--,--,--,--,--,--,--,--,--,--,--,--,
--,--,--,--,--,63,43,65,66,65,43,24,67,--,--,--,--,--,--,26,--,--,--,--,--,00,43,04,--,--,05,48,52,78,78,78,--,--,--,--,--,--,--,--,--,--,--,--,--,--,
--,--,--,--,--,63,24,44,66,22,65,66,46,--,--,--,--,--,05,49,--,--,--,--,--,42,23,67,--,--,28,90,26,90,90,90,--,--,--,--,--,--,--,--,--,--,--,--,--,--,
--,--,--,--,--,42,45,43,22,24,44,43,25,--,--,--,--,--,28,90,--,--,00,03,02,52,45,44,48,48,49,--,26,--,--,--,--,00,03,02,04,--,--,--,--,--,--,--,--,--,
--,--,--,--,--,21,23,30,87,86,31,64,43,48,48,48,48,48,25,--,--,--,63,12,13,14,43,46,90,90,90,--,26,--,--,--,--,21,43,45,67,--,--,--,--,--,--,--,--,--,
--,--,--,--,--,63,43,46,90,90,42,44,46,90,90,90,90,90,28,--,00,02,52,33,40,35,66,25,--,--,--,--,47,48,48,48,48,65,64,22,25,--,--,--,--,--,--,--,--,--,
--,--,--,--,--,42,24,25,--,--,63,23,67,--,--,--,--,--,47,48,63,43,65,54,55,56,65,46,--,--,--,--,90,90,90,90,90,42,44,24,46,--,--,--,--,--,--,--,--,--,
--,--,--,--,--,21,23,67,--,--,84,87,88,--,--,--,--,--,90,90,84,86,87,85,86,31,44,67,--,--,--,--,--,--,--,--,--,63,66,23,67,--,--,--,--,--,--,--,--,--,
--,--,--,--,--,63,22,46,--,--,90,90,90,--,--,--,--,--,--,--,90,90,90,90,90,84,87,88,--,--,--,--,--,--,--,--,--,84,86,85,88,--,--,--,--,--,--,--,--,--,
--,--,--,--,--,84,87,88,--,--,--,--,--,--,--,--,--,--,--,--,--,--,--,--,--,90,90,90,--,--,--,--,--,--,--,--,--,90,90,90,90,--,--,--,--,--,--,--,--,--,
--,--,--,--,--,90,90,90,--,--,--,--,--,--,--,--,--,--,--,--,--,--,--,--,--,--,--,--,--,--,--,--,--,--,--,--,--,--,--,--,--,--,--,--,--,--,--,--,--,--,
--,--,--,--,--,--,--,--,--,--,--,--,--,--,--,--,--,--,--,--,--,--,--,--,--,--,--,--,--,--,--,--,--,--,--,--,--,--,--,--,--,--,--,--,--,--,--,--,--,--,
--,--,--,--,--,--,--,--,--,--,--,--,--,--,--,--,--,--,--,--,--,--,--,--,--,--,--,--,--,--,--,--,--,--,--,--,--,--,--,--,--,--,--,--,--,--,--,--,--,--,
--,--,--,--,--,--,--,--,--,--,--,--,--,--,--,--,--,--,--,--,--,--,--,--,--,--,--,--,--,--,--,--,--,--,--,--,--,--,--,--,--,--,--,--,--,--,--,--,--,--,
--,--,--,--,--,--,--,--,--,--,--,--,--,--,--,--,--,--,--,--,--,--,--,--,--,--,--,--,--,--,--,--,--,--,--,--,--,--,--,--,--,--,--,--,--,--,--,--,--,--,
--,--,--,--,--,--,--,--,--,--,--,--,--,--,--,--,--,--,--,--,--,--,--,--,--,--,--,--,--,--,--,--,--,--,--,--,--,--,--,--,--,--,--,--,--,--,--,--,--,--,
--,--,--,--,--,--,--,--,--,--,--,--,--,--,--,--,--,--,--,--,--,--,--,--,--,--,--,--,--,--,--,--,--,--,--,--,--,--,--,--,--,--,--,--,--,--,--,--,--,--,


--,--,--,--,--,--,--,--,--,--,--,--,--,--,--,--,--,--,--,--,--,--,--,--,--,--,--,--,--,--,--,--,--,--,--,--,--,--,--,--,--,--,--,--,--,--,--,--,--,--,
--,--,--,--,--,--,--,--,--,--,--,--,--,--,--,--,--,--,--,--,--,--,--,--,--,--,--,--,--,--,--,--,--,--,--,--,--,--,--,--,--,--,--,--,--,--,--,--,--,--,
--,--,--,--,--,--,--,--,--,--,--,--,--,--,--,--,--,--,--,--,--,--,--,--,--,--,--,--,--,--,--,--,--,--,--,--,--,--,--,--,--,--,--,--,--,--,--,--,--,--,
--,--,--,--,--,--,--,--,--,--,--,--,--,--,--,--,--,--,--,--,--,--,--,--,--,--,--,--,--,--,--,--,--,--,--,--,--,--,--,--,--,--,--,--,--,--,--,--,--,--,
--,--,--,--,--,--,--,--,--,--,--,--,--,--,--,--,--,--,--,--,--,--,--,--,--,--,--,--,--,--,--,--,--,--,--,--,--,--,--,--,--,--,--,--,--,--,--,--,--,--,
--,--,--,--,--,--,--,--,--,--,--,--,--,--,--,--,--,--,--,--,--,--,--,--,--,--,--,--,--,--,--,--,--,--,--,--,--,--,--,--,--,--,--,--,--,--,--,--,--,--,
--,--,--,--,--,--,--,--,--,--,--,--,--,--,--,--,--,--,--,--,--,--,--,--,--,--,--,--,--,--,--,--,--,--,--,--,--,--,--,--,--,--,--,--,--,--,--,--,--,--,
--,--,--,--,--,--,--,--,--,--,--,--,--,--,--,--,--,--,--,--,--,--,--,--,--,--,--,--,--,--,--,--,--,--,--,--,--,--,--,--,LC,--,--,--,--,--,--,--,--,--,
--,--,--,--,LC,--,--,--,--,--,--,--,--,--,--,--,--,--,--,--,--,--,--,--,--,--,--,--,--,--,--,--,--,--,--,--,--,--,--,--,--,CH,--,--,--,--,--,--,--,--,
--,--,--,--,--,--,--,--,--,--,--,--,--,--,--,--,--,--,--,--,--,--,--,--,--,--,--,--,--,--,--,--,--,--,--,--,BA,--,--,--,--,--,--,--,--,--,--,--,--,--,
--,--,--,--,--,--,--,--,--,--,--,--,--,--,--,--,--,--,--,--,--,--,--,--,--,--,SC,--,CH,--,--,--,--,--,--,--,--,--,--,--,--,--,--,--,--,--,--,--,--,--,
--,--,--,--,--,--,--,BA,--,--,--,--,--,--,--,--,--,--,--,--,--,--,--,--,--,--,--,--,--,TO,--,--,--,--,--,--,--,--,--,--,--,--,--,--,--,--,--,--,--,--,
--,--,--,--,--,CH,--,--,--,--,--,--,--,--,--,--,--,--,--,--,--,--,--,--,--,--,--,--,--,--,--,--,--,--,--,--,--,--,--,--,--,--,--,--,--,--,--,--,--,--,
--,--,--,--,--,--,--,RG,--,--,--,--,--,--,--,--,--,--,--,--,--,--,--,--,--,--,--,LC,--,--,--,--,--,--,--,--,--,TO,--,--,--,--,--,--,--,--,--,--,--,--,
--,--,--,--,--,SC,--,TO,--,--,--,--,--,--,--,--,SC,--,--,BA,CH,--,--,--,--,--,--,--,--,--,--,--,--,--,--,--,--,SC,--,--,--,--,--,--,--,--,--,--,--,--,
--,--,--,--,--,--,--,--,--,--,--,--,--,--,--,--,--,--,--,--,--,--,--,--,--,--,--,--,--,--,--,--,--,--,--,--,--,--,DG,--,--,--,--,--,--,--,--,--,--,--,
--,--,--,--,--,--,--,--,--,--,--,--,--,--,--,--,--,--,LC,--,--,--,--,--,--,BA,TO,--,--,--,--,--,--,--,--,--,--,--,--,--,--,--,--,--,--,--,--,--,--,--,
--,--,--,--,--,--,--,--,--,--,--,SC,--,--,--,--,--,--,--,--,--,--,--,--,--,--,BG,--,--,--,--,--,--,--,--,--,--,--,--,--,--,--,--,--,--,--,--,--,--,--,
--,--,--,--,--,--,--,--,--,--,--,--,--,--,--,--,--,--,--,--,TO,--,--,--,--,--,--,--,--,--,--,--,--,--,--,--,--,--,--,--,--,--,--,--,--,--,--,--,--,--,
--,--,--,--,--,--,--,--,LC,--,--,--,--,--,--,--,--,--,--,--,--,--,--,--,--,--,--,--,--,--,--,--,--,--,--,--,--,--,--,--,CH,--,--,--,--,--,--,--,--,--,
--,--,--,--,--,--,--,--,--,--,--,TO,--,--,--,--,--,--,--,--,--,--,--,--,--,--,--,--,--,--,--,--,--,--,--,--,--,LC,--,--,--,--,--,--,--,--,--,--,--,--,
--,--,--,--,--,--,--,--,--,--,--,--,--,--,--,--,--,--,--,--,--,--,--,--,--,--,--,--,--,--,LC,--,--,--,--,--,--,--,--,SC,--,TO,--,--,--,--,--,--,--,--,
--,--,--,--,--,--,--,--,--,--,--,--,--,--,--,CH,BA,--,--,--,--,--,--,--,--,--,--,--,--,--,--,--,--,--,--,--,--,--,--,KG,--,--,--,--,--,--,--,--,--,--,
--,--,--,--,--,--,--,--,--,--,--,--,--,--,--,--,--,--,--,--,--,--,--,--,--,--,--,--,--,--,--,--,--,--,--,--,--,--,--,--,--,--,BA,--,--,--,--,--,--,--,
--,--,--,--,--,--,--,--,--,--,--,--,--,--,--,--,--,SC,--,--,--,CH,--,--,--,--,--,--,--,--,TO,--,--,--,--,--,--,--,--,--,--,--,--,--,--,--,--,--,--,--,
--,--,--,--,--,--,--,--,--,--,--,TO,--,--,--,--,--,--,--,--,--,--,--,--,--,--,--,--,--,--,--,--,--,--,--,--,--,--,--,--,--,--,--,--,--,--,--,--,--,--,
--,--,--,--,--,--,--,--,--,--,--,--,--,--,--,--,--,--,--,--,--,--,--,--,--,--,--,--,--,--,--,--,CH,--,--,BA,--,--,--,--,--,--,--,--,--,--,--,--,--,--,
--,--,--,--,--,--,--,--,--,--,--,DG,--,--,--,--,--,TO,--,GG,--,SC,--,--,--,--,--,--,--,--,--,--,--,--,--,--,--,--,--,--,--,--,--,--,--,--,--,--,--,--,
--,--,--,--,--,--,--,--,--,--,--,BA,--,--,--,--,--,--,--,--,--,--,--,--,--,--,--,--,--,--,--,--,--,--,SC,--,--,--,--,--,--,--,--,--,--,--,--,--,--,--,
--,--,--,--,--,--,--,--,--,--,--,--,--,--,--,--,BA,--,--,--,--,--,--,--,--,--,--,--,--,--,LC,--,--,BG,--,--,--,--,--,--,--,--,--,--,--,--,--,--,--,--,
--,--,--,--,--,--,--,--,--,--,--,--,--,--,--,--,--,--,--,--,--,--,--,--,--,--,--,--,--,--,--,--,--,--,--,TO,--,--,--,--,--,--,--,--,--,--,--,--,--,--,
--,--,--,--,--,--,--,--,--,--,--,--,--,--,--,--,--,--,LC,--,--,--,--,--,--,--,--,--,--,--,--,--,--,--,--,--,--,--,--,--,--,--,--,--,--,--,--,--,--,--,
--,--,--,--,--,--,--,LC,--,--,--,--,--,--,--,--,--,--,--,--,--,--,--,--,--,--,--,--,--,--,--,--,--,--,--,--,--,--,--,--,--,--,--,--,--,--,--,--,--,--,
--,--,--,--,--,--,TO,--,--,--,--,--,--,--,--,--,--,--,--,--,--,--,--,--,--,--,--,--,--,--,--,--,--,--,--,--,--,--,--,--,--,--,--,--,--,--,--,--,--,--,
--,--,--,--,--,--,--,--,--,KG,--,SC,--,--,--,--,--,--,--,--,--,--,--,--,--,--,--,--,--,--,--,--,--,--,--,--,--,--,--,--,--,--,--,--,--,--,--,--,--,--,
--,--,--,--,--,--,CH,--,--,--,--,--,--,--,--,--,--,--,--,--,--,--,--,--,--,--,--,--,--,--,--,--,--,--,--,--,--,--,--,--,--,--,--,--,--,--,--,--,--,--,
--,--,--,--,--,--,--,--,--,--,--,TO,--,--,--,--,--,--,--,--,--,--,--,--,--,--,RG,--,--,--,--,--,--,--,--,--,--,--,--,--,--,--,--,--,--,--,--,--,--,--,
--,--,--,--,--,--,--,--,BA,--,--,--,--,--,--,--,--,--,--,--,--,--,--,--,--,--,--,--,--,--,--,--,--,--,--,--,--,--,CH,--,SC,--,--,--,--,--,--,--,--,--,
--,--,--,--,--,--,--,--,--,--,--,--,--,--,--,--,--,--,--,--,--,--,--,--,--,--,CH,--,--,--,--,--,--,--,--,--,--,--,--,TO,--,--,--,--,--,--,--,--,--,--,
--,--,--,--,--,--,--,--,--,--,--,--,--,--,--,--,--,--,--,--,--,--,LC,--,--,--,TO,--,--,--,--,--,--,--,--,--,--,--,GG,--,--,--,--,--,--,--,--,--,--,--,
--,--,--,--,--,--,--,--,--,--,--,LC,--,--,--,--,--,--,--,--,--,--,--,--,--,--,--,--,--,--,--,--,--,--,--,--,--,--,--,--,BA,--,--,--,--,--,--,--,--,--,
--,--,--,--,--,BA,--,--,--,--,--,--,--,--,--,--,--,--,--,--,--,--,--,--,--,BA,--,--,--,--,--,--,--,--,--,--,--,--,--,--,--,--,--,--,--,--,--,--,--,--,
--,--,--,--,--,--,--,--,--,--,--,--,--,--,--,--,--,--,--,--,--,--,--,--,--,--,--,--,--,--,--,--,--,--,--,--,--,--,--,--,--,--,--,--,--,--,--,--,--,--,
--,--,--,--,--,--,--,--,--,--,--,--,--,--,--,--,--,--,--,--,--,--,--,--,--,--,--,--,--,--,--,--,--,--,--,--,--,--,--,--,--,--,--,--,--,--,--,--,--,--,
--,--,--,--,--,--,--,--,--,--,--,--,--,--,--,--,--,--,--,--,--,--,--,--,--,--,--,--,--,--,--,--,--,--,--,--,--,--,--,--,--,--,--,--,--,--,--,--,--,--,
--,--,--,--,--,--,--,--,--,--,--,--,--,--,--,--,--,--,--,--,--,--,--,--,--,--,--,--,--,--,--,--,--,--,--,--,--,--,--,--,--,--,--,--,--,--,--,--,--,--,
--,--,--,--,--,--,--,--,--,--,--,--,--,--,--,--,--,--,--,--,--,--,--,--,--,--,--,--,--,--,--,--,--,--,--,--,--,--,--,--,--,--,--,--,--,--,--,--,--,--,
--,--,--,--,--,--,--,--,--,--,--,--,--,--,--,--,--,--,--,--,--,--,--,--,--,--,--,--,--,--,--,--,--,--,--,--,--,--,--,--,--,--,--,--,--,--,--,--,--,--,
--,--,--,--,--,--,--,--,--,--,--,--,--,--,--,--,--,--,--,--,--,--,--,--,--,--,--,--,--,--,--,--,--,--,--,--,--,--,--,--,--,--,--,--,--,--,--,--,--,--,
--,--,--,--,--,--,--,--,--,--,--,--,--,--,--,--,--,--,--,--,--,--,--,--,--,--,--,--,--,--,--,--,--,--,--,--,--,--,--,--,--,--,--,--,--,--,--,--,--,--,